DlrRLTDDDD
DudRDDDDDD
DDDRDDDDDD
DDDDDDDDDD
DDDDDDDDDD
DDDDDDDDDD
DDDDDDDDDD
DDDDDDDDDD
DDDDDDDDDD
DDDDDDDDDD